7 13
0000001000000
1101111111010
1100000000010
0101100111010
0001000001010
0111110131210
0000000100100
